//MAP CONVERTED BY dmm2tgm.py THIS HEADER COMMENT PREVENTS RECONVERSION, DO NOT REMOVE
"ai" = (
/turf/closed/wall/r_wall,
/area/template_noop)
"al" = (
/turf/open/floor/grass,
/area/template_noop)
"aw" = (
/turf/closed/wall/r_wall,
/area/ruin/unpowered/tar_temple)
"aS" = (
/obj/machinery/door/airlock/vault,
/turf/open/floor/plasteel/dark,
/area/ruin/unpowered/tar_temple)
"aV" = (
/turf/open/space/basic,
/area/ruin/unpowered/tar_temple)
"aY" = (
/turf/open/floor/plasteel/dark,
/area/ruin/unpowered/tar_temple)
"oD" = (
/obj/structure/tar_altar,
/turf/open/space/basic,
/area/ruin/unpowered/tar_temple)
"RE" = (
/obj/item/flashlight/lantern,
/turf/open/floor/grass,
/area/template_noop)
"Uh" = (
/obj/structure/fans/tiny/invisible,
/turf/open/floor/plasteel/dark,
/area/ruin/unpowered/tar_temple)

(1,1,1) = {"
al
al
al
al
al
al
aw
aw
aw
aw
aw
aw
aw
aw
aw
aw
aw
aw
aw
aw
aw
aw
aw
aw
aw
aw
aw
aw
al
al
al
al
al
al
al
al
al
al
al
"}
(2,1,1) = {"
al
al
al
al
al
aw
aw
aY
aY
aY
aY
aY
aY
aY
aY
aY
aY
aY
aY
aY
aY
aY
aY
aY
aY
aY
aY
aw
aw
al
al
al
al
al
al
al
al
al
al
"}
(3,1,1) = {"
al
al
al
al
aw
aw
aY
aY
aY
aY
aY
aY
aY
aY
aY
aY
aY
aY
aY
aY
aY
aY
aY
aY
aY
aY
aY
aY
aw
aw
al
al
al
al
al
al
al
al
al
"}
(4,1,1) = {"
al
al
al
al
aw
aY
aY
aY
aY
aw
aw
aw
aw
aw
aw
aw
aw
aw
aw
aw
aw
aw
aw
aw
aw
aw
aY
aY
aY
aw
aw
al
al
al
al
al
al
al
al
"}
(5,1,1) = {"
al
al
al
al
aw
aY
aY
aY
aw
aw
aV
aV
aV
aV
aV
aV
aV
aV
aV
aV
aV
aV
aV
aV
aV
aw
aY
aY
aY
aY
aw
aw
al
al
al
al
al
al
al
"}
(6,1,1) = {"
al
al
al
al
aw
aY
aY
aw
aw
aV
aV
aV
aV
aV
aV
aV
aV
aV
aV
aV
aV
aV
aV
aV
aV
aw
aw
aw
aY
aY
aY
aw
aw
al
al
al
al
al
al
"}
(7,1,1) = {"
al
al
al
al
aw
aY
aY
aw
aV
aV
aV
aV
aV
aV
aV
aV
aV
aV
aV
aV
aV
aV
aV
aV
aV
aV
aV
aw
aw
aY
aY
aY
aw
aw
al
al
al
al
al
"}
(8,1,1) = {"
al
al
al
aw
aw
aY
aY
aw
aV
aV
aV
aV
aV
aV
aV
aV
aV
aV
aV
aV
aV
aV
aV
aV
aV
aV
aV
aV
aw
aw
aY
aY
aY
aw
aw
al
al
al
al
"}
(9,1,1) = {"
al
al
aw
aw
aY
aY
aY
aw
aV
aV
aV
aV
aV
aV
aV
aV
aV
aV
aV
aV
aV
aV
aV
aV
aV
aV
aV
aV
aV
aw
aw
aY
aY
aY
aw
al
al
al
al
"}
(10,1,1) = {"
al
aw
aw
aY
aY
aY
aw
aw
aV
aV
aV
aV
aV
aV
aV
aV
aV
aV
aV
aV
aV
aV
aV
aV
aV
aV
aV
aV
aV
aV
aw
aw
aY
aY
aw
al
al
al
al
"}
(11,1,1) = {"
aw
aw
aY
aY
aY
aw
aw
aV
aV
aV
aV
aV
aV
aV
aV
aV
aV
aV
aV
aV
aV
aV
aV
aV
aV
aV
aV
aV
aV
aV
aV
aw
aY
aY
aw
aw
al
al
al
"}
(12,1,1) = {"
aw
aY
aY
aY
aw
aw
aV
aV
aV
aV
aV
aV
aV
aV
aV
aV
aV
aV
aV
aV
aV
aV
aV
aV
aV
aV
aV
aV
aV
aV
aV
aw
aY
aY
aY
aw
al
al
al
"}
(13,1,1) = {"
aw
aY
aY
aw
aw
aV
aV
aV
aV
aV
aV
aV
aV
aV
aV
aV
aV
aV
aV
aV
aV
aV
aV
aV
aV
aV
aV
aV
aV
aV
aV
aw
aY
aY
aY
aw
al
al
al
"}
(14,1,1) = {"
aw
aY
aY
aw
aV
aV
aV
aV
aV
aV
aV
aV
aV
aV
aV
aV
aV
aV
aV
aV
aV
aV
aV
aV
aV
aV
aV
aV
aV
aV
aV
aw
aw
aY
aY
aw
al
al
al
"}
(15,1,1) = {"
aw
aY
aY
aw
aV
aV
aV
aV
aV
aV
aV
aV
aV
aV
aV
aV
aV
aV
aV
aV
aV
aV
aV
aV
aV
aV
aV
aV
aV
aV
aV
aV
aw
aY
aY
aw
al
al
al
"}
(16,1,1) = {"
aw
aY
aY
aw
aV
aV
aV
aV
aV
aV
aV
aV
aV
aV
aV
aV
aV
aV
aV
aV
aV
aV
aV
aV
aV
aV
aV
aV
aV
aV
aV
aV
aw
aY
aY
aw
al
al
al
"}
(17,1,1) = {"
aw
aY
aY
aw
aV
aV
aV
aV
aV
aV
aV
aV
aV
aV
aV
aV
aV
aV
aV
aV
aV
aV
aV
aV
aV
aV
aV
aV
aV
aV
aV
aV
aw
aY
aY
aw
ai
al
al
"}
(18,1,1) = {"
aw
aY
aY
aw
aV
aV
aV
aV
aV
aV
aV
aV
aV
aV
aV
aV
aV
aV
aV
aV
aV
aV
aV
aV
aV
aV
aV
aV
aV
aV
aV
aV
aw
aY
aY
aY
aS
al
al
"}
(19,1,1) = {"
aw
aY
aY
Uh
aV
aV
aV
aV
aV
aV
aV
aV
aV
aV
aV
aV
aV
aV
aV
aV
aV
oD
aV
aV
aV
aV
aV
aV
aV
aV
aV
aV
aw
aY
aY
aY
aS
al
al
"}
(20,1,1) = {"
aw
aY
aY
aw
aV
aV
aV
aV
aV
aV
aV
aV
aV
aV
aV
aV
aV
aV
aV
aV
aV
aV
aV
aV
aV
aV
aV
aV
aV
aV
aV
aV
aw
aY
aY
aY
aS
al
al
"}
(21,1,1) = {"
aw
aY
aY
aw
aV
aV
aV
aV
aV
aV
aV
aV
aV
aV
aV
aV
aV
aV
aV
aV
aV
aV
aV
aV
aV
aV
aV
aV
aV
aV
aV
aV
aw
aY
aY
aw
ai
al
RE
"}
(22,1,1) = {"
aw
aY
aY
aw
aV
aV
aV
aV
aV
aV
aV
aV
aV
aV
aV
aV
aV
aV
aV
aV
aV
aV
aV
aV
aV
aV
aV
aV
aV
aV
aV
aV
aw
aY
aY
aw
al
al
al
"}
(23,1,1) = {"
aw
aY
aY
aw
aV
aV
aV
aV
aV
aV
aV
aV
aV
aV
aV
aV
aV
aV
aV
aV
aV
aV
aV
aV
aV
aV
aV
aV
aV
aV
aV
aV
aw
aY
aY
aw
al
al
al
"}
(24,1,1) = {"
aw
aY
aY
aw
aV
aV
aV
aV
aV
aV
aV
aV
aV
aV
aV
aV
aV
aV
aV
aV
aV
aV
aV
aV
aV
aV
aV
aV
aV
aV
aV
aw
aw
aY
aY
aw
al
al
al
"}
(25,1,1) = {"
aw
aY
aY
aw
aw
aV
aV
aV
aV
aV
aV
aV
aV
aV
aV
aV
aV
aV
aV
aV
aV
aV
aV
aV
aV
aV
aV
aV
aV
aV
aV
aw
aY
aY
aY
aw
al
al
al
"}
(26,1,1) = {"
aw
aY
aY
aY
aw
aw
aV
aV
aV
aV
aV
aV
aV
aV
aV
aV
aV
aV
aV
aV
aV
aV
aV
aV
aV
aV
aV
aV
aV
aV
aV
aw
aY
aY
aY
aw
al
al
al
"}
(27,1,1) = {"
aw
aw
aY
aY
aY
aw
aw
aV
aV
aV
aV
aV
aV
aV
aV
aV
aV
aV
aV
aV
aV
aV
aV
aV
aV
aV
aV
aV
aV
aV
aV
aw
aY
aY
aw
aw
al
al
al
"}
(28,1,1) = {"
al
aw
aw
aY
aY
aY
aw
aw
aV
aV
aV
aV
aV
aV
aV
aV
aV
aV
aV
aV
aV
aV
aV
aV
aV
aV
aV
aV
aV
aV
aw
aw
aY
aY
aw
al
al
al
al
"}
(29,1,1) = {"
al
al
aw
aw
aY
aY
aY
aw
aV
aV
aV
aV
aV
aV
aV
aV
aV
aV
aV
aV
aV
aV
aV
aV
aV
aV
aV
aV
aV
aw
aw
aY
aY
aY
aw
al
al
al
al
"}
(30,1,1) = {"
al
al
al
aw
aw
aY
aY
aw
aV
aV
aV
aV
aV
aV
aV
aV
aV
aV
aV
aV
aV
aV
aV
aV
aV
aV
aV
aV
aw
aw
aY
aY
aY
aw
aw
al
al
al
al
"}
(31,1,1) = {"
al
al
al
al
aw
aY
aY
aw
aV
aV
aV
aV
aV
aV
aV
aV
aV
aV
aV
aV
aV
aV
aV
aV
aV
aV
aV
aw
aw
aY
aY
aY
aw
aw
al
al
al
al
al
"}
(32,1,1) = {"
al
al
al
al
aw
aY
aY
aw
aw
aV
aV
aV
aV
aV
aV
aV
aV
aV
aV
aV
aV
aV
aV
aV
aV
aw
aw
aw
aY
aY
aY
aw
aw
al
al
al
al
al
al
"}
(33,1,1) = {"
al
al
al
al
aw
aY
aY
aY
aw
aw
aV
aV
aV
aV
aV
aV
aV
aV
aV
aV
aV
aV
aV
aV
aV
aw
aY
aY
aY
aY
aw
aw
al
al
al
al
al
al
al
"}
(34,1,1) = {"
al
al
al
al
aw
aY
aY
aY
aY
aw
aw
aw
aw
aw
aw
aw
aw
aw
aw
aw
aw
aw
aw
aw
aw
aw
aY
aY
aY
aw
aw
al
al
al
al
al
al
al
al
"}
(35,1,1) = {"
al
al
al
al
aw
aw
aY
aY
aY
aY
aY
aY
aY
aY
aY
aY
aY
aY
aY
aY
aY
aY
aY
aY
aY
aY
aY
aY
aw
aw
al
al
al
al
al
al
al
al
al
"}
(36,1,1) = {"
al
al
al
al
al
aw
aw
aY
aY
aY
aY
aY
aY
aY
aY
aY
aY
aY
aY
aY
aY
aY
aY
aY
aY
aY
aY
aw
aw
al
al
al
al
al
al
al
al
al
al
"}
(37,1,1) = {"
al
al
al
al
al
al
aw
aw
aw
aw
aw
aw
aw
aw
aw
aw
aw
aw
aw
aw
aw
aw
aw
aw
aw
aw
aw
aw
al
al
al
al
al
al
al
al
al
al
al
"}
