//MAP CONVERTED BY dmm2tgm.py THIS HEADER COMMENT PREVENTS RECONVERSION, DO NOT REMOVE
"ai" = (
/turf/open/floor/grass,
/area/template_noop)
"al" = (
/turf/open/floor/plasteel/rockvault/alien,
/area/ruin/unpowered/tar_temple)
"aw" = (
/turf/closed/wall/r_wall,
/area/ruin/unpowered/tar_temple)
"aS" = (
/obj/machinery/door/airlock/vault,
/turf/open/floor/plasteel/dark,
/area/ruin/unpowered/tar_temple)
"aV" = (
/turf/open/space/basic,
/area/ruin/unpowered/tar_temple)
"aY" = (
/turf/open/floor/plating/dirt/jungleland/barren_rocks,
/area/ruin/unpowered/tar_temple)
"Oy" = (
/turf/closed/wall/r_wall,
/area/template_noop)
"OY" = (
/turf/open/floor/plasteel/dark,
/area/ruin/unpowered/tar_temple)
"RE" = (
/obj/item/flashlight/lantern,
/turf/open/floor/grass,
/area/template_noop)
"Uh" = (
/obj/structure/fans/tiny/invisible,
/turf/open/floor/plating/dirt/jungleland/barren_rocks,
/area/ruin/unpowered/tar_temple)
"Ws" = (
/obj/structure/tar_altar,
/turf/open/space/basic,
/area/ruin/unpowered/tar_temple)

(1,1,1) = {"
ai
ai
ai
ai
ai
ai
aw
aw
aw
aw
aw
aw
aw
aw
aw
aw
aw
aw
aw
aw
aw
aw
aw
aw
aw
aw
aw
aw
ai
ai
ai
ai
ai
ai
ai
ai
ai
ai
ai
"}
(2,1,1) = {"
ai
ai
ai
ai
ai
aw
aw
aY
aY
aY
aY
aY
aY
aY
aY
aY
aY
aY
aY
aY
aY
aY
aY
aY
aY
aY
aY
aw
aw
ai
ai
ai
ai
ai
ai
ai
ai
ai
ai
"}
(3,1,1) = {"
ai
ai
ai
ai
aw
aw
aY
aY
aY
aY
aY
aY
aY
aY
aY
aY
aY
aY
aY
aY
aY
aY
aY
aY
aY
aY
aY
aY
aw
aw
ai
ai
ai
ai
ai
ai
ai
ai
ai
"}
(4,1,1) = {"
ai
ai
ai
ai
aw
aY
aY
aY
aY
aw
aw
aw
aw
aw
aw
aw
aw
aw
aw
aw
aw
aw
aw
aw
aw
aw
aY
aY
aY
aw
aw
ai
ai
ai
ai
ai
ai
ai
ai
"}
(5,1,1) = {"
ai
ai
ai
ai
aw
aY
aY
aY
aw
aw
aV
aV
aV
aV
aV
aV
aV
aV
aV
aV
aV
aV
aV
aV
aV
aw
aY
aY
aY
aY
aw
aw
ai
ai
ai
ai
ai
ai
ai
"}
(6,1,1) = {"
ai
ai
ai
ai
aw
aY
aY
aw
aw
aV
aV
aV
aV
aV
aV
aV
aV
aV
aV
aV
aV
aV
aV
aV
aV
aw
aw
aw
aY
aY
aY
aw
aw
ai
ai
ai
ai
ai
ai
"}
(7,1,1) = {"
ai
ai
ai
ai
aw
aY
aY
aw
aV
aV
aV
aV
aV
aV
aV
aV
aV
aV
aV
aV
aV
aV
aV
aV
aV
aV
aV
aw
aw
aY
aY
aY
aw
aw
ai
ai
ai
ai
ai
"}
(8,1,1) = {"
ai
ai
ai
aw
aw
aY
aY
aw
aV
aV
aV
aV
aV
aV
aV
aV
aV
aV
aV
aV
aV
aV
aV
aV
aV
aV
aV
aV
aw
aw
aY
aY
aY
aw
aw
ai
ai
ai
ai
"}
(9,1,1) = {"
ai
ai
aw
aw
aY
aY
aY
aw
aV
aV
aV
aV
aV
aV
aV
aV
aV
aV
aV
aV
aV
aV
aV
aV
aV
aV
aV
aV
aV
aw
aw
aY
al
al
aw
ai
ai
ai
ai
"}
(10,1,1) = {"
ai
aw
aw
aY
aY
aY
aw
aw
aV
aV
aV
aV
aV
aV
aV
aV
aV
aV
aV
aV
aV
aV
aV
aV
aV
aV
aV
aV
aV
aV
aw
aw
al
al
aw
ai
ai
ai
ai
"}
(11,1,1) = {"
aw
aw
aY
aY
aY
aw
aw
aV
aV
aV
aV
aV
aV
aV
aV
aV
aV
aV
aV
aV
aV
aV
aV
aV
aV
aV
aV
aV
aV
aV
aV
aw
al
al
aw
aw
ai
ai
ai
"}
(12,1,1) = {"
aw
aY
aY
aY
aw
aw
aV
aV
aV
aV
aV
aV
aV
aV
aV
aV
aV
aV
aV
aV
aV
aV
aV
aV
aV
aV
aV
aV
aV
aV
aV
aw
al
al
al
aw
ai
ai
ai
"}
(13,1,1) = {"
aw
aY
aY
aw
aw
aV
aV
aV
aV
aV
aV
aV
aV
aV
aV
aV
aV
aV
aV
aV
aV
aV
aV
aV
aV
aV
aV
aV
aV
aV
aV
aw
al
al
al
aw
ai
ai
ai
"}
(14,1,1) = {"
aw
aY
aY
aw
aV
aV
aV
aV
aV
aV
aV
aV
aV
aV
aV
aV
aV
aV
aV
aV
aV
aV
aV
aV
aV
aV
aV
aV
aV
aV
aV
aw
aw
al
al
aw
ai
ai
ai
"}
(15,1,1) = {"
aw
aY
aY
aw
aV
aV
aV
aV
aV
aV
aV
aV
aV
aV
aV
aV
aV
aV
aV
aV
aV
aV
aV
aV
aV
aV
aV
aV
aV
aV
aV
aV
aw
al
al
aw
ai
ai
ai
"}
(16,1,1) = {"
aw
aY
aY
aw
aV
aV
aV
aV
aV
aV
aV
aV
aV
aV
aV
aV
aV
aV
aV
aV
aV
aV
aV
aV
aV
aV
aV
aV
aV
aV
aV
aV
aw
al
al
aw
ai
ai
ai
"}
(17,1,1) = {"
aw
aY
aY
aw
aV
aV
aV
aV
aV
aV
aV
aV
aV
aV
aV
aV
aV
aV
aV
aV
aV
aV
aV
aV
aV
aV
aV
aV
aV
aV
aV
aV
aw
OY
OY
aw
Oy
ai
ai
"}
(18,1,1) = {"
aw
aY
aY
aw
aV
aV
aV
aV
aV
aV
aV
aV
aV
aV
aV
aV
aV
aV
aV
aV
aV
aV
aV
aV
aV
aV
aV
aV
aV
aV
aV
aV
aw
OY
OY
OY
aS
ai
ai
"}
(19,1,1) = {"
aw
aY
aY
Uh
aV
aV
aV
aV
aV
aV
aV
aV
aV
aV
aV
aV
aV
aV
aV
aV
aV
Ws
aV
aV
aV
aV
aV
aV
aV
aV
aV
aV
aw
OY
OY
OY
aS
ai
ai
"}
(20,1,1) = {"
aw
aY
aY
aw
aV
aV
aV
aV
aV
aV
aV
aV
aV
aV
aV
aV
aV
aV
aV
aV
aV
aV
aV
aV
aV
aV
aV
aV
aV
aV
aV
aV
aw
OY
OY
OY
aS
ai
ai
"}
(21,1,1) = {"
aw
aY
aY
aw
aV
aV
aV
aV
aV
aV
aV
aV
aV
aV
aV
aV
aV
aV
aV
aV
aV
aV
aV
aV
aV
aV
aV
aV
aV
aV
aV
aV
aw
OY
OY
aw
Oy
ai
RE
"}
(22,1,1) = {"
aw
aY
aY
aw
aV
aV
aV
aV
aV
aV
aV
aV
aV
aV
aV
aV
aV
aV
aV
aV
aV
aV
aV
aV
aV
aV
aV
aV
aV
aV
aV
aV
aw
al
al
aw
ai
ai
ai
"}
(23,1,1) = {"
aw
aY
aY
aw
aV
aV
aV
aV
aV
aV
aV
aV
aV
aV
aV
aV
aV
aV
aV
aV
aV
aV
aV
aV
aV
aV
aV
aV
aV
aV
aV
aV
aw
al
al
aw
ai
ai
ai
"}
(24,1,1) = {"
aw
aY
aY
aw
aV
aV
aV
aV
aV
aV
aV
aV
aV
aV
aV
aV
aV
aV
aV
aV
aV
aV
aV
aV
aV
aV
aV
aV
aV
aV
aV
aw
aw
al
al
aw
ai
ai
ai
"}
(25,1,1) = {"
aw
aY
aY
aw
aw
aV
aV
aV
aV
aV
aV
aV
aV
aV
aV
aV
aV
aV
aV
aV
aV
aV
aV
aV
aV
aV
aV
aV
aV
aV
aV
aw
al
al
al
aw
ai
ai
ai
"}
(26,1,1) = {"
aw
aY
aY
aY
aw
aw
aV
aV
aV
aV
aV
aV
aV
aV
aV
aV
aV
aV
aV
aV
aV
aV
aV
aV
aV
aV
aV
aV
aV
aV
aV
aw
al
al
al
aw
ai
ai
ai
"}
(27,1,1) = {"
aw
aw
aY
aY
aY
aw
aw
aV
aV
aV
aV
aV
aV
aV
aV
aV
aV
aV
aV
aV
aV
aV
aV
aV
aV
aV
aV
aV
aV
aV
aV
aw
aY
aY
aw
aw
ai
ai
ai
"}
(28,1,1) = {"
ai
aw
aw
aY
aY
aY
aw
aw
aV
aV
aV
aV
aV
aV
aV
aV
aV
aV
aV
aV
aV
aV
aV
aV
aV
aV
aV
aV
aV
aV
aw
aw
aY
aY
aw
ai
ai
ai
ai
"}
(29,1,1) = {"
ai
ai
aw
aw
aY
aY
aY
aw
aV
aV
aV
aV
aV
aV
aV
aV
aV
aV
aV
aV
aV
aV
aV
aV
aV
aV
aV
aV
aV
aw
aw
aY
aY
aY
aw
ai
ai
ai
ai
"}
(30,1,1) = {"
ai
ai
ai
aw
aw
aY
aY
aw
aV
aV
aV
aV
aV
aV
aV
aV
aV
aV
aV
aV
aV
aV
aV
aV
aV
aV
aV
aV
aw
aw
aY
aY
aY
aw
aw
ai
ai
ai
ai
"}
(31,1,1) = {"
ai
ai
ai
ai
aw
aY
aY
aw
aV
aV
aV
aV
aV
aV
aV
aV
aV
aV
aV
aV
aV
aV
aV
aV
aV
aV
aV
aw
aw
aY
aY
aY
aw
aw
ai
ai
ai
ai
ai
"}
(32,1,1) = {"
ai
ai
ai
ai
aw
aY
aY
aw
aw
aV
aV
aV
aV
aV
aV
aV
aV
aV
aV
aV
aV
aV
aV
aV
aV
aw
aw
aw
aY
aY
aY
aw
aw
ai
ai
ai
ai
ai
ai
"}
(33,1,1) = {"
ai
ai
ai
ai
aw
aY
aY
aY
aw
aw
aV
aV
aV
aV
aV
aV
aV
aV
aV
aV
aV
aV
aV
aV
aV
aw
aY
aY
aY
aY
aw
aw
ai
ai
ai
ai
ai
ai
ai
"}
(34,1,1) = {"
ai
ai
ai
ai
aw
aY
aY
aY
aY
aw
aw
aw
aw
aw
aw
aw
aw
aw
aw
aw
aw
aw
aw
aw
aw
aw
aY
aY
aY
aw
aw
ai
ai
ai
ai
ai
ai
ai
ai
"}
(35,1,1) = {"
ai
ai
ai
ai
aw
aw
aY
aY
aY
aY
aY
aY
aY
aY
aY
aY
aY
aY
aY
aY
aY
aY
aY
aY
aY
aY
aY
aY
aw
aw
ai
ai
ai
ai
ai
ai
ai
ai
ai
"}
(36,1,1) = {"
ai
ai
ai
ai
ai
aw
aw
aY
aY
aY
aY
aY
aY
aY
aY
aY
aY
aY
aY
aY
aY
aY
aY
aY
aY
aY
aY
aw
aw
ai
ai
ai
ai
ai
ai
ai
ai
ai
ai
"}
(37,1,1) = {"
ai
ai
ai
ai
ai
ai
aw
aw
aw
aw
aw
aw
aw
aw
aw
aw
aw
aw
aw
aw
aw
aw
aw
aw
aw
aw
aw
aw
ai
ai
ai
ai
ai
ai
ai
ai
ai
ai
ai
"}
